#####################
       #            #
# ######### ####### #
#           #       #
############# #######
#     #             #
# ### ########## ####
#   #               #
# ###################
#                   X
#####################